NO textures/norte.xpm
SO textures/sur.xpm

WE textures/oeste.xpm

EA textures/este.xpm   


F 162, 140, 107
C 135, 206, 235



1111111111
1000000001
1101100001
100010N001
1000100001
1000100001
1000100001
1000100001
1111111111
