NO textures/norte.xpm
SO textures/sur.xpm
WE textures/oeste.xpm
EA textures/este.xpm  

C 72, 3, 93
F 79, 19, 19   

111111111111111111111111     
11000010000100000001111111 
10000000000000000000001001
11100000100000000000000011    11111111111
11000000000000000000000001    10000000001
1100000000000000000E00001    1000111110111
11000000000000010000000001111100001   10001
11000000100000000011000000000000001   100111
110000000000000100000000011111100001111001
10100000000000100000000001    100000000001
10000000000000000000000001    111111111111
1111111111111111111111111